{
  "width": 60,
  "height": 60,
  "tiles": [
[1,1,1,1,1,1,1,1,1,1,1,1,1,1,1,1,1,1,1,1,1,1,1,1,1,1,1,1,1,1,1,1,1,1,1,1,1,1,1,1,1,1,1,1,1,1,1,1,1,1,1,1,1,1,1,1,1,1,1,1],
[1,0,0,1,1,1,1,1,2,1,1,1,1,0,0,1,1,1,2,1,1,1,1,0,0,1,1,1,2,1,1,1,1,0,0,1,1,1,2,1,1,1,1,0,0,1,1,1,2,1,1,1,1,0,0,1,1,1,1,1,1],
[1,0,0,1,1,1,1,1,2,1,1,1,1,0,0,1,1,1,2,1,1,1,1,0,0,1,1,1,2,1,1,1,1,0,0,1,1,1,2,1,1,1,1,0,0,1,1,1,2,1,1,1,1,0,0,1,1,1,1,1,1],
[1,1,1,1,1,1,1,1,1,1,1,1,1,1,1,1,1,1,1,1,1,1,1,1,1,1,1,1,1,1,1,1,1,1,1,1,1,1,1,1,1,1,1,1,1,1,1,1,1,1,1,1,1,1,1,1,1,1,1,1],
[1,1,1,1,1,1,1,1,1,1,1,1,1,1,1,1,1,1,1,1,1,1,1,1,1,1,1,1,1,1,1,1,1,1,1,1,1,1,1,1,1,1,1,1,1,1,1,1,1,1,1,1,1,1,1,1,1,1,1,1],
[1,0,0,1,1,1,1,1,2,1,1,1,1,0,0,1,1,1,2,1,1,1,1,0,0,1,1,1,2,1,1,1,1,0,0,1,1,1,2,1,1,1,1,0,0,1,1,1,2,1,1,1,1,0,0,1,1,1,1,1,1],
[1,0,0,1,1,1,1,1,2,1,1,1,1,0,0,1,1,1,2,1,1,1,1,0,0,1,1,1,2,1,1,1,1,0,0,1,1,1,2,1,1,1,1,0,0,1,1,1,2,1,1,1,1,0,0,1,1,1,1,1,1],
[1,1,1,1,1,1,1,1,1,1,1,1,1,1,1,1,1,1,1,1,1,1,1,1,1,1,1,1,1,1,1,1,1,1,1,1,1,1,1,1,1,1,1,1,1,1,1,1,1,1,1,1,1,1,1,1,1,1,1,1],
[1,1,1,1,1,1,1,1,1,1,1,1,1,1,1,1,1,1,1,1,1,1,1,1,1,1,1,1,1,1,1,1,1,1,1,1,1,1,1,1,1,1,1,1,1,1,1,1,1,1,1,1,1,1,1,1,1,1,1,1],
[1,0,0,1,1,1,1,1,2,1,1,1,1,0,0,1,1,1,2,1,1,1,1,0,0,1,1,1,2,1,1,1,1,0,0,1,1,1,2,1,1,1,1,0,0,1,1,1,2,1,1,1,1,0,0,1,1,1,1,1,1],
[1,0,0,1,1,1,1,1,2,1,1,1,1,0,0,1,1,1,2,1,1,1,1,0,0,1,1,1,2,1,1,1,1,0,0,1,1,1,2,1,1,1,1,0,0,1,1,1,2,1,1,1,1,0,0,1,1,1,1,1,1],
[1,1,1,1,1,1,1,1,1,1,1,1,1,1,1,1,1,1,1,1,1,1,1,1,1,1,1,1,1,1,1,1,1,1,1,1,1,1,1,1,1,1,1,1,1,1,1,1,1,1,1,1,1,1,1,1,1,1,1,1],
[1,1,1,1,1,1,1,1,1,1,1,1,1,1,1,1,1,1,1,1,1,1,1,1,1,1,1,1,1,1,1,1,1,1,1,1,1,1,1,1,1,1,1,1,1,1,1,1,1,1,1,1,1,1,1,1,1,1,1,1],
[1,0,0,1,1,1,1,1,2,1,1,1,1,0,0,1,1,1,2,1,1,1,1,0,0,1,1,1,2,1,1,1,1,0,0,1,1,1,2,1,1,1,1,0,0,1,1,1,2,1,1,1,1,0,0,1,1,1,1,1,1],
[1,0,0,1,1,1,1,1,2,1,1,1,1,0,0,1,1,1,2,1,1,1,1,0,0,1,1,1,2,1,1,1,1,0,0,1,1,1,2,1,1,1,1,0,0,1,1,1,2,1,1,1,1,0,0,1,1,1,1,1,1],
[1,1,1,1,1,1,1,1,1,1,1,1,1,1,1,1,1,1,1,1,1,1,1,1,1,1,1,1,1,1,1,1,1,1,1,1,1,1,1,1,1,1,1,1,1,1,1,1,1,1,1,1,1,1,1,1,1,1,1,1],
[1,1,1,1,1,1,1,1,1,1,1,1,1,1,1,1,1,1,1,1,1,1,1,1,1,1,1,1,1,1,1,1,1,1,1,1,1,1,1,1,1,1,1,1,1,1,1,1,1,1,1,1,1,1,1,1,1,1,1,1],
[1,0,0,1,1,1,1,1,2,1,1,1,1,0,0,1,1,1,2,1,1,1,1,0,0,1,1,1,2,1,1,1,1,0,0,1,1,1,2,1,1,1,1,0,0,1,1,1,2,1,1,1,1,0,0,1,1,1,1,1,1],
[1,0,0,1,1,1,1,1,2,1,1,1,1,0,0,1,1,1,2,1,1,1,1,0,0,1,1,1,2,1,1,1,1,0,0,1,1,1,2,1,1,1,1,0,0,1,1,1,2,1,1,1,1,0,0,1,1,1,1,1,1],
[1,1,1,1,1,1,1,1,1,1,1,1,1,1,1,1,1,1,1,1,1,1,1,1,1,1,1,1,1,1,1,1,1,1,1,1,1,1,1,1,1,1,1,1,1,1,1,1,1,1,1,1,1,1,1,1,1,1,1,1],
[1,1,1,1,1,1,1,1,1,1,1,1,1,1,1,1,1,1,1,1,1,1,1,1,1,1,1,1,1,1,1,1,1,1,1,1,1,1,1,1,1,1,1,1,1,1,1,1,1,1,1,1,1,1,1,1,1,1,1,1],
[1,0,0,1,1,1,1,1,2,1,1,1,1,0,0,1,1,1,2,1,1,1,1,0,0,1,1,1,2,1,1,1,1,0,0,1,1,1,2,1,1,1,1,0,0,1,1,1,2,1,1,1,1,0,0,1,1,1,1,1,1],
[1,0,0,1,1,1,1,1,2,1,1,1,1,0,0,1,1,1,2,1,1,1,1,0,0,1,1,1,2,1,1,1,1,0,0,1,1,1,2,1,1,1,1,0,0,1,1,1,2,1,1,1,1,0,0,1,1,1,1,1,1],
[1,1,1,1,1,1,1,1,1,1,1,1,1,1,1,1,1,1,1,1,1,1,1,1,1,1,1,1,1,1,1,1,1,1,1,1,1,1,1,1,1,1,1,1,1,1,1,1,1,1,1,1,1,1,1,1,1,1,1,1],
[1,1,1,1,1,1,1,1,1,1,1,1,1,1,1,1,1,1,1,1,1,1,1,1,1,1,1,1,1,1,1,1,1,1,1,1,1,1,1,1,1,1,1,1,1,1,1,1,1,1,1,1,1,1,1,1,1,1,1,1],
[1,0,0,1,1,1,1,1,2,1,1,1,1,0,0,1,1,1,2,1,1,1,1,0,0,1,1,1,2,1,1,1,1,0,0,1,1,1,2,1,1,1,1,0,0,1,1,1,2,1,1,1,1,0,0,1,1,1,1,1,1],
[1,0,0,1,1,1,1,1,2,1,1,1,1,0,0,1,1,1,2,1,1,1,1,0,0,1,1,1,2,1,1,1,1,0,0,1,1,1,2,1,1,1,1,0,0,1,1,1,2,1,1,1,1,0,0,1,1,1,1,1,1],
[1,1,1,1,1,1,1,1,1,1,1,1,1,1,1,1,1,1,1,1,1,1,1,1,1,1,1,1,1,1,1,1,1,1,1,1,1,1,1,1,1,1,1,1,1,1,1,1,1,1,1,1,1,1,1,1,1,1,1,1],
[1,1,1,1,1,1,1,1,1,1,1,1,1,1,1,1,1,1,1,1,1,1,1,1,1,1,1,1,1,1,1,1,1,1,1,1,1,1,1,1,1,1,1,1,1,1,1,1,1,1,1,1,1,1,1,1,1,1,1,1],
[1,0,0,1,1,1,1,1,2,1,1,1,1,0,0,1,1,1,2,1,1,1,1,0,0,1,1,1,2,1,1,1,1,0,0,1,1,1,2,1,1,1,1,0,0,1,1,1,2,1,1,1,1,0,0,1,1,1,1,1,1],
[1,0,0,1,1,1,1,1,2,1,1,1,1,0,0,1,1,1,2,1,1,1,1,0,0,1,1,1,2,1,1,1,1,0,0,1,1,1,2,1,1,1,1,0,0,1,1,1,2,1,1,1,1,0,0,1,1,1,1,1,1],
[1,1,1,1,1,1,1,1,1,1,1,1,1,1,1,1,1,1,1,1,1,1,1,1,1,1,1,1,1,1,1,1,1,1,1,1,1,1,1,1,1,1,1,1,1,1,1,1,1,1,1,1,1,1,1,1,1,1,1,1],
[1,1,1,1,1,1,1,1,1,1,1,1,1,1,1,1,1,1,1,1,1,1,1,1,1,1,1,1,1,1,1,1,1,1,1,1,1,1,1,1,1,1,1,1,1,1,1,1,1,1,1,1,1,1,1,1,1,1,1,1],
[1,0,0,1,1,1,1,1,2,1,1,1,1,0,0,1,1,1,2,1,1,1,1,0,0,1,1,1,2,1,1,1,1,0,0,1,1,1,2,1,1,1,1,0,0,1,1,1,2,1,1,1,1,0,0,1,1,1,1,1,1],
[1,0,0,1,1,1,1,1,2,1,1,1,1,0,0,1,1,1,2,1,1,1,1,0,0,1,1,1,2,1,1,1,1,0,0,1,1,1,2,1,1,1,1,0,0,1,1,1,2,1,1,1,1,0,0,1,1,1,1,1,1],
[1,1,1,1,1,1,1,1,1,1,1,1,1,1,1,1,1,1,1,1,1,1,1,1,1,1,1,1,1,1,1,1,1,1,1,1,1,1,1,1,1,1,1,1,1,1,1,1,1,1,1,1,1,1,1,1,1,1,1,1],
[1,1,1,1,1,1,1,1,1,1,1,1,1,1,1,1,1,1,1,1,1,1,1,1,1,1,1,1,1,1,1,1,1,1,1,1,1,1,1,1,1,1,1,1,1,1,1,1,1,1,1,1,1,1,1,1,1,1,1,1],
[1,0,0,1,1,1,1,1,2,1,1,1,1,0,0,1,1,1,2,1,1,1,1,0,0,1,1,1,2,1,1,1,1,0,0,1,1,1,2,1,1,1,1,0,0,1,1,1,2,1,1,1,1,0,0,1,1,1,1,1,1],
[1,0,0,1,1,1,1,1,2,1,1,1,1,0,0,1,1,1,2,1,1,1,1,0,0,1,1,1,2,1,1,1,1,0,0,1,1,1,2,1,1,1,1,0,0,1,1,1,2,1,1,1,1,0,0,1,1,1,1,1,1],
[1,1,1,1,1,1,1,1,1,1,1,1,1,1,1,1,1,1,1,1,1,1,1,1,1,1,1,1,1,1,1,1,1,1,1,1,1,1,1,1,1,1,1,1,1,1,1,1,1,1,1,1,1,1,1,1,1,1,1,1],
[1,1,1,1,1,1,1,1,1,1,1,1,1,1,1,1,1,1,1,1,1,1,1,1,1,1,1,1,1,1,1,1,1,1,1,1,1,1,1,1,1,1,1,1,1,1,1,1,1,1,1,1,1,1,1,1,1,1,1,1],
[1,0,0,1,1,1,1,1,2,1,1,1,1,0,0,1,1,1,2,1,1,1,1,0,0,1,1,1,2,1,1,1,1,0,0,1,1,1,2,1,1,1,1,0,0,1,1,1,2,1,1,1,1,0,0,1,1,1,1,1,1],
[1,0,0,1,1,1,1,1,2,1,1,1,1,0,0,1,1,1,2,1,1,1,1,0,0,1,1,1,2,1,1,1,1,0,0,1,1,1,2,1,1,1,1,0,0,1,1,1,2,1,1,1,1,0,0,1,1,1,1,1,1],
[1,1,1,1,1,1,1,1,1,1,1,1,1,1,1,1,1,1,1,1,1,1,1,1,1,1,1,1,1,1,1,1,1,1,1,1,1,1,1,1,1,1,1,1,1,1,1,1,1,1,1,1,1,1,1,1,1,1,1,1],
[1,1,1,1,1,1,1,1,1,1,1,1,1,1,1,1,1,1,1,1,1,1,1,1,1,1,1,1,1,1,1,1,1,1,1,1,1,1,1,1,1,1,1,1,1,1,1,1,1,1,1,1,1,1,1,1,1,1,1,1],
[1,0,0,1,1,1,1,1,2,1,1,1,1,0,0,1,1,1,2,1,1,1,1,0,0,1,1,1,2,1,1,1,1,0,0,1,1,1,2,1,1,1,1,0,0,1,1,1,2,1,1,1,1,0,0,1,1,1,1,1,1],
[1,0,0,1,1,1,1,1,2,1,1,1,1,0,0,1,1,1,2,1,1,1,1,0,0,1,1,1,2,1,1,1,1,0,0,1,1,1,2,1,1,1,1,0,0,1,1,1,2,1,1,1,1,0,0,1,1,1,1,1,1],
[1,1,1,1,1,1,1,1,1,1,1,1,1,1,1,1,1,1,1,1,1,1,1,1,1,1,1,1,1,1,1,1,1,1,1,1,1,1,1,1,1,1,1,1,1,1,1,1,1,1,1,1,1,1,1,1,1,1,1,1],
[1,1,1,1,1,1,1,1,1,1,1,1,1,1,1,1,1,1,1,1,1,1,1,1,1,1,1,1,1,1,1,1,1,1,1,1,1,1,1,1,1,1,1,1,1,1,1,1,1,1,1,1,1,1,1,1,1,1,1,1],
[1,0,0,1,1,1,1,1,2,1,1,1,1,0,0,1,1,1,2,1,1,1,1,0,0,1,1,1,2,1,1,1,1,0,0,1,1,1,2,1,1,1,1,0,0,1,1,1,2,1,1,1,1,0,0,1,1,1,1,1,1],
[1,0,0,1,1,1,1,1,2,1,1,1,1,0,0,1,1,1,2,1,1,1,1,0,0,1,1,1,2,1,1,1,1,0,0,1,1,1,2,1,1,1,1,0,0,1,1,1,2,1,1,1,1,0,0,1,1,1,1,1,1],
[1,1,1,1,1,1,1,1,1,1,1,1,1,1,1,1,1,1,1,1,1,1,1,1,1,1,1,1,1,1,1,1,1,1,1,1,1,1,1,1,1,1,1,1,1,1,1,1,1,1,1,1,1,1,1,1,1,1,1,1],
[1,1,1,1,1,1,1,1,1,1,1,1,1,1,1,1,1,1,1,1,1,1,1,1,1,1,1,1,1,1,1,1,1,1,1,1,1,1,1,1,1,1,1,1,1,1,1,1,1,1,1,1,1,1,1,1,1,1,1,1],
[1,0,0,1,1,1,1,1,2,1,1,1,1,0,0,1,1,1,2,1,1,1,1,0,0,1,1,1,2,1,1,1,1,0,0,1,1,1,2,1,1,1,1,0,0,1,1,1,2,1,1,1,1,0,0,1,1,1,1,1,1],
[1,0,0,1,1,1,1,1,2,1,1,1,1,0,0,1,1,1,2,1,1,1,1,0,0,1,1,1,2,1,1,1,1,0,0,1,1,1,2,1,1,1,1,0,0,1,1,1,2,1,1,1,1,0,0,1,1,1,1,1,1],
[1,1,1,1,1,1,1,1,1,1,1,1,1,1,1,1,1,1,1,1,1,1,1,1,1,1,1,1,1,1,1,1,1,1,1,1,1,1,1,1,1,1,1,1,1,1,1,1,1,1,1,1,1,1,1,1,1,1,1,1],
[1,1,1,1,1,1,1,1,1,1,1,1,1,1,1,1,1,1,1,1,1,1,1,1,1,1,1,1,1,1,1,1,1,1,1,1,1,1,1,1,1,1,1,1,1,1,1,1,1,1,1,1,1,1,1,1,1,1,1,1],
[1,0,0,1,1,1,1,1,2,1,1,1,1,0,0,1,1,1,2,1,1,1,1,0,0,1,1,1,2,1,1,1,1,0,0,1,1,1,2,1,1,1,1,0,0,1,1,1,2,1,1,1,1,0,0,1,1,1,1,1,1],
[1,0,0,1,1,1,1,1,2,1,1,1,1,0,0,1,1,1,2,1,1,1,1,0,0,1,1,1,2,1,1,1,1,0,0,1,1,1,2,1,1,1,1,0,0,1,1,1,2,1,1,1,1,0,0,1,1,1,1,1,1],
[1,1,1,1,1,1,1,1,1,1,1,1,1,1,1,1,1,1,1,1,1,1,1,1,1,1,1,1,1,1,1,1,1,1,1,1,1,1,1,1,1,1,1,1,1,1,1,1,1,1,1,1,1,1,1,1,1,1,1,1],
[1,1,1,1,1,1,1,1,1,1,1,1,1,1,1,1,1,1,1,1,1,1,1,1,1,1,1,1,1,1,1,1,1,1,1,1,1,1,1,1,1,1,1,1,1,1,1,1,1,1,1,1,1,1,1,1,1,1,1,1],
[1,0,0,1,1,1,1,1,2,1,1,1,1,0,0,1,1,1,2,1,1,1,1,0,0,1,1,1,2,1,1,1,1,0,0,1,1,1,2,1,1,1,1,0,0,1,1,1,2,1,1,1,1,0,0,1,1,1,1,1,1],
[1,0,0,1,1,1,1,1,2,1,1,1,1,0,0,1,1,1,2,1,1,1,1,0,0,1,1,1,2,1,1,1,1,0,0,1,1,1,2,1,1,1,1,0,0,1,1,1,2,1,1,1,1,0,0,1,1,1,1,1,1]
  ],
  "collision": "derive_from_tiles",
  "spawns": [
    { "x": 2, "y": 1 },
    { "x": 14, "y": 1 },
    { "x": 26, "y": 5 },
    { "x": 40, "y": 10 },
    { "x": 10, "y": 20 },
    { "x": 30, "y": 30 }
  ]
}